Type,Product,Started Date,Completed Date,Description,Amount,Fee,Currency,Status,Balance
CARD_PAYMENT,Current,28/01/2025 21:35,28/01/2025 21:35,Texts,-4.79,0,EUR,COMPLETED,800
CARD_PAYMENT,Current,27/01/2025 21:35,27/01/2025 21:35,Shop Pay,-36.9,0,EUR,COMPLETED,763.1
CARD_PAYMENT,Current,27/01/2025 21:35,27/01/2025 21:35,Texts,-67.8,0,EUR,COMPLETED,695.3
CARD_PAYMENT,Current,27/01/2025 21:35,27/01/2025 21:35,Shop Pay,-7.49,0,EUR,COMPLETED,687.81
CARD_PAYMENT,Current,25/01/2025 21:35,25/01/2025 21:35,Bitcoin,-4.79,0,EUR,COMPLETED,683.02
CARD_PAYMENT,Current,25/01/2025 21:35,25/01/2025 21:35,Texts,-36.9,0,EUR,COMPLETED,646.12
CARD_PAYMENT,Current,24/01/2025 21:35,24/01/2025 21:35,Shop Pay,-67.8,0,EUR,COMPLETED,578.32
CARD_PAYMENT,Current,24/01/2025 21:35,24/01/2025 21:35,Texts,-98.7,0,EUR,COMPLETED,479.62
CARD_PAYMENT,Current,24/01/2025 21:35,24/01/2025 21:35,Shop Pay,-129.6,0,EUR,COMPLETED,350.02
